# # # # # # # # # # # # # # # # #
# T . . . . . . . . . . . . . . #
# . # # # # # # # # # # # # # . #
# . . . . . . . . . # . . . . . #
# . . . . . . . . . # . # # # # #
# . . . . . . . . . # . . . . . #
# . . . . . . . . . # # # # # . #
# . . . . . . . . . # . . . . . #
# . . . . . . . . . # . # # # # #
# . . . . . . . . . # . . . . . #
# . . . . . . . . . # # # # # . #
# . . . . . . . . . . . . . . . #
# # # # # # # # # # # # # # # S #
