# # # # # # # # # # # # # # # M #
# D . . . . . . . . . . . . . . #
# . # # # # # # # # # # # # # . #
# . . . . . . . . . # . . . . . #
# . . . . . . . . . # . # # # # #
# . . . . . . . . . # . . . . . #
# . . . . . . . . . # # # # # . #
# . . . . . . . . . # . . . . . #
# . . . . . . . . . # . # # # # #
# . . . . . . . . . # . . . . . #
# . . . . . . . . . # # # # # . #
# . . . . . . . . . . . . . . . #
# # # # # # # # # # # # # # # # #
