# # # # # # # # # # # # # # # # #
# D . . . . . . . . . . . . . . #
# . # # # # # # # # # # # # # . #
# . . . . . . . . . # . . . . . #
# . . . . . . . . . # . # # # # #
# . . . . . . . . . # . . . . . #
# . . . . . . . . . # # # # # . #
# . . . . . . . . . # . . . . . #
# . . . . . . . . . # . # # # # #
# . . . . . . . . . # . . . . . #
# . . . . . . . . . # # # # # . #
# . . . . . . . . . . . . . . . #
# # # # # # # # # # # # # # # M #
