# # # # # # # # # # # # # # # # #
# T . . . . . . # . . . . . . . #
# . . . . . . . # . . . . . . . #
# . . . . . . . # . . . . . . . #
# . . . . . . . # . . . . . . . #
# . . . . . . . # . . . . . . . #
# . . . . . . . # . . . . . . . #
# . . . . . . . # . . . . . . . #
# . . . . . . . # . . . . . . . #
# . . . . . . . # . . . . . . . #
# . . . . . . . # . . . . . . . #
# . . . . . . . # . . . . . . . #
# . . . . . . . # . . . . . . . #
# . . . . . . . # . . . . . . . #
# . . . . . . . # . . . . . . . #
# . . . . . . . # . . . . . . . #
# . . . . . . . # . . . . . . . #
# . . . . . . . # . . . . . . . #
# . . . . . . . # . . . . . . . #
# # # # # # # # # # # # # # # S #
