# # # # # # # # # # # # # # # # #
# T . . . . . . . . . . . . . . #
# . . . . . . . . . . . . . . . #
# . . . . . . . . . . . . . . . #
# . . . . . . . . . . . . . . . #
# . . . . . . . . . . . . . . . #
# . . . . . . . . . . . . . . . #
# . . . . . . . . . . . . . . . #
# . . . . . . . . . . . . . . . #
# . . . . . . . . . . . . . . . #
# . . . . . . . . . . . . . . . #
# . . . . . . . . . . . . . . . #
# # # # # # # # # # # # # # # S #
