# # # # # # # # # # # # # # # # #
# D . . . . . . # . . . . . . . #
# . . . . . . . # . . . . . . . #
# . . . . . . . # . . . . . . . #
# . . . . . . . # . . . . . . . #
# . . . . . . . # . . . . . . . #
# . . . . . . . # . . . . . . . #
# . . . . . . . # . . . . . . . #
# . . . . . . . # . . . . . . . #
# . . . . . . . # . . . . . . . #
# . . . . . . . # . . . . . . . #
# . . . . . . . # . . . . . . . #
# . . . . . . . # . . . . . . . #
# . . . . . . . # . . . . . . . #
# . . . . . . . # . . . . . . . #
# . . . . . . . # . . . . . . . #
# . . . . . . . # . . . . . . . #
# . . . . . . . # . . . . . . . #
# . . . . . . . # . . . . . . . #
# # # # # # # # # # # # # # # M #
