# # # # # # # # # # # # # # # # #
# D . . . . . . . . . . . . . . #
# . . . . . . . . . . . . . . . #
# . . . . . . . . . . . . . . . #
# . . . . . . . . . . . . . . . #
# . . . . . . . . . . . . . . . #
# . . . . . . . . . . . . . . . #
# . . . . . . . . . . . . . . . #
# . . . . . . . . . . . . . . . #
# . . . . . . . . . . . . . . . #
# . . . . . . . . . . . . . . . #
# . . . . . . . . . . . . . . . #
# . . . . . . . . . . . . . . . #
# # # # # # # # # # # # # # # M #
